1111111111111111111111
10010000000000110000C1
100001111111T000011001
1P0011E000000011111001
1111111111111111111111