1111111111111111111111
10C1000000001C110000C1
1000001T0T0T1000011001
1000001T0T0T1000011001
1000001T0T0T1000011001
1000001T0T0T1000011001
1P0011E0000000111110C1
1111111111111111111111